border_size=1
usage=map

Mm          , Mm          , Mm          , Mm          , Mm          , Mm          , Mm          , Mm          , Gs^Fp       , Gs^Fp       , Gs^Fp       , Gs          , Gs          , Gs          , Re          , Re          , Ur          , Ur          , Ur          , Ur          , Ur          , Ur          , Ur          , Mm          , Mm          , Mm          , Ur          , Ur          , Ur          , Ur          , Re          , Re          , Ur          , Mm          , Hh          , Mm          , Hh          , Hh          , Hh          , Hh          , Gs          , Gs          
Mm          , Mm          , Mm          , Mm          , Mm          , Mm          , Mm          , Mm          , Gs^Fp       , Gs^Fp       , Gs^Fp       , Gs          , Re          , Re          , Rd          , Rd          , Rd          , Rd          , Rd          , Ur          , Ur          , Ur          , Ur          , Mm          , Mm          , Mm          , Ur          , Ur          , Ur          , Ur          , Ur          , Ur          , Rd          , Mm          , Hh^Vhh      , Mm          , Hh          , Hh          , Hh          , Hh          , Ss          , Ss          
Mm          , Mm          , Mm          , Mm          , Hh          , Hh          , Hh          , Hh          , Hh          , Gs^Fp       , Gs^Fp       , Re          , Rd          , Rd          , Gs^Fdw      , Re          , Re          , Ur          , Ur          , Rd          , Rd          , Ur          , Rd          , Gs^Fmw      , Gs^Fmw      , Gs^Fdw      , Rd          , Rd          , Rd          , Ur          , Rd          , Rd          , Gs^Fmw      , Hh          , Hh          , Hh          , Hh          , Hh          , Gs^Fp       , Ss          , Ww          , Ww          
Hh          , Hh          , Hh          , Hh          , Hh          , Hh          , Hh          , Hh          , Gs^Fp       , Gs^Fp       , Gs          , Re          , Re          , Gs^Fdw      , Gs^Fdw      , Gs^Fdw      , Gs^Fmw      , Gs^Fmw      , Gs^Fmw      , Ur          , Gs^Fmw      , Rd          , Gs^Fdw      , Rd          , Rd          , Rd          , Hh          , Ur          , Ur          , Rd          , Rd          , Gs^Fp       , Gs^Fmw      , Gs^Fdw      , Gs^Fdw      , Gs^Fdw      , Gs^Fmw      , Gs^Fmw      , Ss          , Ww          , Ww          , Ww          
Hh          , Hh          , Hh          , Hh          , Gs          , Gs^Fp       , Gs^Fp       , Gs^Fp       , Gs^Fp       , Gs^Fp       , Gs          , Gs          , Gs          , Gs^Fdw      , Gs^Fdw      , Gs^Fdw      , Gs^Fmw      , Gs^Fdw      , Gs^Fdw      , Gs^Fdw      , Gs^Fdw      , Gs^Fmw      , Gs^Fdw      , Gs^Fmw      , Ur          , Ur          , Hh          , Gs^Fp       , Ur          , Ur          , Rd          , Gs^Fp       , Gs^Fmw      , Gs^Fdw      , Ur          , Gs^Fdw      , Ur          , Ss          , Ww          , Ww          , Ww          , Ww          
Hh          , Hh          , Ww          , Gs          , Ww          , Gs          , Ww          , Gs          , Ww          , Gs          , Ww          , Gs          , Gs          , Gs          , Ww          , Gs^Fmw      , Gs^Fmw      , Gs^Fmw      , Gs          , Gs^Fdw      , Gs          , Gs^Fmw      , Gs^Fmw      , Gs^Fmw      , Re          , Gs^Fmw      , Gs^Fmw      , Gs^Fp       , Ur          , Ur          , Ur          , Rd          , Rd          , Ur          , Ur          , Ur          , Ww          , Ww          , Ww          , Ww          , Ww          , Ww          
Ww          , Ww          , Wo          , Ww          , Wo          , Ww          , Wo          , Ww          , Wo          , Ww          , Wo          , Ww          , Ww          , Ww          , Ww          , Ww          , Ww          , Ww          , Ww          , Ww          , Ww          , Gs          , Gs          , Gs          , Gs          , Gs          , Ww          , Ur          , Ww          , Ur          , Gs^Fdw      , Rd          , Rr          , Gs^Fdw      , Wwf         , Ww          , Ww          , Ww          , Ww          , Ww          , Ww          , Ww          
Wo          , Wo          , Wo          , Wo          , Wo          , Wo          , Wo          , Wo          , Wo          , Wo          , Wo          , Wo          , Wo          , Wo          , Wo          , Wo          , Wo          , Ww          , Wo          , Wo          , Wo          , Ww          , Ww          , Ww          , Ww          , Ww          , Wo          , Ww          , Wo          , Ww          , Ww          , Wwf         , Rr          , Ww          , Wwf         , Wwf         , Ww          , Ww          , Ww          , Ww          , Ww          , Ww          
Wo          , Wo          , Ww          , Wo          , Ww          , Wo          , Ww          , Wo          , Ww          , Wo          , Ww          , Wo          , Wo          , Wo          , Wo          , Wo          , Wo          , Wo          , Gs^Fmw      , Gs^Fmw      , Gs^Fmw      , Wo          , Wo          , Wo          , Wo          , Wo          , Wo          , Wo          , Wo          , Wo          , Wo          , Ww          , Wwf         , Wwf         , Ww          , Wwf         , Ww          , Ww          , Ww          , Ww          , Ww          , Ww          
Ww          , Ww          , Hh          , Ww          , Gs          , Ww          , Gs^Fmw      , Ww          , Gs^Fmw      , Ww          , Ww          , Ww          , Ww          , Ww          , Ww          , Ww          , Ww          , Wo          , Wo          , Gs^Fmw      , Wo          , Gs          , Wo          , Wo          , Wo          , Wo          , Ww          , Wo          , Ww          , Ww          , Ww          , Ww          , Ww          , Wwf         , Wwf         , Wwf         , Ww          , Ww          , Ww          , Ww          , Ww          , Ww          
Hh          , Hh          , Hh          , Gs          , Re          , Ss          , Re          , Gs^Fmw      , Re          , Gs^Fdw      , Gs^Fmw      , Gs^Fmw      , Gs^Fmw      , Gs          , Gs          , Gs          , Gs          , Ww          , Ww          , Ww          , Ww          , Ww          , Ww          , Ww          , Ww          , Ww          , Ww          , Ww          , Ww          , Ww          , Ww          , Ww          , Wwf         , Wwf         , Wwf         , Wwf         , Wwf         , Ww          , Ww          , Ww          , Ww          , Ww          
Hh          , Hh          , Gs^Fdw      , Re          , Ur          , Re          , Ur          , Re          , Re          , Gs^Fdw      , Gs^Fdw      , Gs^Fdw      , Gs^Fdw      , Re^Gvs      , Re^Gvs      , Re^Gvs      , Re^Gvs      , Gs          , Gs          , Gs          , Gs          , Gs          , Gs          , Gs          , Gs          , Gs          , Gs          , Ww          , Wwf         , Ww          , Wwf         , Ww          , Wwf         , Ww          , Wwf         , Wwf         , Ww          , Ww          , Ss          , Ss          , Ss          , Ss          
Re          , Re          , Re          , Re          , Ur          , Ur          , Uu          , Ur          , Ur          , Re          , Re          , Gs^Fdw      , Re          , Re^Gvs      , Re^Gvs      , Re^Gvs      , Gs^Fdw      , Gs^Fdw      , Gs^Fdw      , Re^Gvs      , Re^Gvs      , Re^Gvs      , Re          , Re^Gvs      , Re          , Re^Gvs      , Re          , Re          , Rd          , Wwf         , Ww          , Wwf         , Rd          , Rd          , Rd          , Ww          , Ss          , Ss          , Gs^Fdw      , Ss          , Rd          , Re          
Re          , Ur          , Uu          , Ur          , Re          , Ur          , Ur          , Uu          , Ur          , Ur          , Ur          , Re          , Re          , Re          , Re          , Re^Gvs      , Gs^Fdw      , Gs^Fdw      , Gs^Fdw      , Re^Gvs      , Re          , Re          , Rd          , Re          , Rd          , Re          , Rd          , Re          , Rd          , Rr          , Rr          , Rr          , Re          , Re          , Rd          , Re          , Rd          , Gs^Fdw      , Rr          , Gs^Fdw      , Rd          , Rd          
Re          , Re          , Re          , Re          , Gs^Fmw      , Re          , Uu          , Ur          , Ur          , Uu          , Uu          , Ur          , Rd          , Rd          , Re          , Re          , Re          , Gs^Fdw      , Rd          , Re          , Rd          , Rd          , Gs^Fdw      , Rd          , Re          , Rd          , Re          , Rd          , Re          , Rd          , Re          , Re          , Re          , Re          , Re          , Rd          , Rd          , Rr          , Rr          , Rr          , Rd          , Rd          
Re          , Ss          , Ww          , Gs^Fmw      , Ss          , Gs^Fmw      , Re          , Ur          , Ur          , Ur          , Ur          , Rd          , Ur          , Ur          , Rd          , Rd          , Rd          , Rd          , Re          , Rd          , Re          , Gs^Fdw      , Gs^Fdw      , Gs^Fdw      , Re          , Rd          , Re          , Re          , Re^Gvs      , Re          , Gs^Fdw      , Gs^Fdw      , Gs^Fdw      , Gs^Fdw      , Gs^Fdw      , Gs^Fmw      , Gs^Fdw      , Rr          , Rr          , Rr          , Rd          , Rd          
Re          , Ss          , Ss          , Ww          , Re          , Re          , Ur          , Ur          , Rd          , Uu          , Ur          , Rd          , Rd          , Rd          , Re          , Re          , Re          , Re          , Gs          , Re          , Gs          , Gs^Fdw      , Gs^Fdw      , Gs^Fdw      , Re          , Rd          , Re          , Re^Gvs      , Re^Gvs      , Gs^Fdw      , Rd          , Gs^Fdw      , Gs^Fdw      , Gs^Fdw      , Gs^Fmw      , Rd          , Gs^Fmw      , Rd          , Gs^Fmw      , Rd          , Rd          , Re          
Re          , Re          , Re          , Ss          , Re          , Uu          , Uu          , Rd          , Re          , Rd          , Rd          , Rd          , Uu          , Re          , Gs^Fdw      , Gs^Fdw      , Gs^Fdw      , Gs^Fdw      , Gs          , Gs          , Gs          , Re          , Rd          , Rd          , Rd          , Rd          , Gs^Fdw      , Re^Gvs      , Gs^Fdw      , Gs^Fdw      , Gs^Fdw      , Gs^Fdw      , Gs^Fdw      , Gs^Fdw      , Gs^Fdw      , Gs^Fdw      , Re          , Gs^Fmw      , Gs^Fdw      , Gs^Fdw      , Re          , Re          
Re          , Re          , Ur          , Re          , Ur          , Uu          , Uu          , Re          , Gs^Fdw      , Re          , Uu          , Rd          , Rd          , Re          , Gs^Fdw      , Gs^Fdw      , Gs^Fdw      , Re          , Gs^Fdw      , Gs          , Gs          , Re          , Gs^Fdw      , Re          , Re          , Gs^Fdw      , Gs^Fdw      , Gs^Fdw      , Gs^Fdw      , Gs^Fdw      , Gs^Fdw      , Gs^Fdw      , Gs^Fdw      , Gs^Fmw      , Gs          , Gs          , Gs          , Gs^Fdw      , Gs^Fmw      , Gs^Fdw      , Re          , Re          
Re          , Ur          , Ur          , Ur          , Re          , Ur          , Re          , Re          , Re          , Re          , Ur          , Ur          , Uu          , Rd          , Rd          , Gs^Fdw      , Rd          , Rd          , Gs^Fdw      , Gs          , Gs          , Gs^Fdw      , Gs^Fmw      , Gs^Fmw      , Re          , Gs^Fdw      , Gs^Fdw      , Gs^Fdw      , Hh          , Gs^Fdw      , Gs          , Gs^Fdw      , Gs^Fdw      , Gs^Fdw      , Gs^Fdw      , Gs^Fdw      , Gs^Fmw      , Gs          , Gs          , Gs          , Gs          , Re          
Re          , Re          , Re          , Re          , Gs^Fdw      , Re          , Gs^Fdw      , Re          , Gs^Fdw      , Re          , Re          , Ur          , Re          , Gs^Fdw      , Re          , Rd          , Re          , Re          , Gs          , Gs          , Gs          , Gs^Fdw      , Gs^Fmw      , Gs^Fdw      , Re          , Re          , Hh          , Hh          , Hh          , Hh          , Hh          , Hh          , Hh          , Gs^Fdw      , Gs^Fmw      , Gs^Fdw      , Gs^Fmw      , Gs          , Gs          , Gs          , Gs          , Gs          
Re          , Re          , Re          , Re          , Gs^Fdw      , Gs^Fdw      , Gs^Fdw      , Gs^Fdw      , Gs^Fdw      , Gs^Fdw      , Gs^Fdw      , Re          , Re          , Gs^Fdw      , Re          , Re          , Gs          , Gs          , Gs          , Gs          , Gs^Fdw      , Gs^Fdw      , Gs^Fdw      , Gs^Fmw      , Re          , Re          , Hh          , Hh          , Hh          , Hh          , Hh          , Hh          , Hh          , Gs^Fdw      , Gs^Fdw      , Gs^Fmw      , Gs^Fmw      , Gs          , Gs          , Gs          , Gs          , Gs          
